{
  "map": [
    [8,8,8,8,9,8,8,0,1,8],
    [2,2,2,2,2,2,2,4,1,8],
    [3,3,3,3,3,3,3,6,1,8],
    [8,8,8,8,8,8,8,0,1,8],
    [8,9,8,8,8,9,8,0,1,8],
    [8,8,8,8,8,8,8,0,1,8],
    [8,8,9,8,8,8,8,0,1,8],
    [8,8,8,8,8,8,8,0,1,8],
    [8,8,8,8,9,8,8,0,1,8],
    [8,8,8,8,8,8,8,0,1,8]
  ]
}